,,,,,,,,,,,,,,,,,,,,,,,,,,,,,,,,,,,,,,,,,,,,,,,,,,,,,,,,,,,,,,,,,,,,,,,,,,,,,,,,,,,,,,,,,,,,,,,,,,,,,,,,,,,,,,,,,,,,,,,,,,,,,,,,,,,,,,,,,,,,,,,,,,,,,,,,,,,,,,,,,,,,,,,,,,,,,,,,,,WWWWWWWWWWWWWWWWWWWWWWWWWWWWWWWWWWWWWWWWWWWWWWWWWWWWWWWWWWWWWWWWWWWWWWWW
,,,,,,,,,,,,,,,,,,,,,,,,,,,,,,,,,,,,,,,,,,,,,,,,,,,,,,,,,,,,,,,,,,,,,,,,,,,,,,,,,,,,,,,,,,,,,,,,,,,,,,,,,,,,,,,,,,,,,,,,,,,,,,,,,,,,,,,,,,,,,,,,,,,,,,,,,,,,,,,,,,,,,,,,,,,,,,,,,WWWWWWWWWWWWWWWWWWWWWWWWWWWWWWWWWWWWWWWWWWWWWWWWWWWWWWWWWWWWWWWWWWWWWWWWW
,,,,,,,,,,,,,,,,,,,,,,,,,,,,,,,,,,,,,,,,,,,,,,,,,,,,,,,,,,,,,,,,,,,,,,,,,,,,,,,,,,,,,,,,,,,,,,,,,,,,,,,,,,,,,,,,,,,,,,,,,,,,,,,,,,,,,,,,,,,,,,,,,,,,,,,,,,,,,,,,,,,,,,,,,,,,,,,WWWWWWWWWWWWWWWWWWWWWWWWWWWWWWWWWWWWWWWWWWWWWWWWWWWWWWWWWWWWWWWWWWWWWWWWWWW
,,,,,,,,,,,,,,,,,,,,,,,,,,,,,,,,,,,,,,,,,,,,,,,,,,,,,,,,,,,,,,,,,,,,,,,,,,,,,,,,,,,,,,,,,,,,,,,,,,,,,,,,,,,,,,,,,,,,,,,,,,,,,,,,,,,,,,,,,,,,,,,,,,,,,,,,,,,,,,,,,,,,,,,,,,,,,WWWWWWWWWWWWWWWWWWWWWWWWWWWWWWWWWWWWWWWWWWWWWWWWWWWWWWWWWWWWWWWWWWWWWWWWWWWWW
,,,,,,,,,,,,,,,,,,,,,,,,,,,,,,,,,,,,,,,,,,,,,,,,,,,,,,,,,,,,,,,,,,,,,,,,,,,,,,,,,,,,,,,,,,,,,,,,,,,,,,,,,,,,,,,,,,,,,,,,,,,,,,,,,,,,,,,,,,,,,,,,,,,,,,,,,,,,,,,,,,,,,,,,,,,WWWWWWWWW,,,,,,,,,,,,,,,,,,,,,,,,,,,,,,,,,,,,,,,,,,,,,,,,,,,,,,,,,,,,,,,,,,,,,,
,,,,,,,,,,,,,,,,,,,,,,,,,,,,,,,,,,,,,,,,,,,,,,,,,,,,,,,,,,,,,,,,,,,,,,,,,,,,,,,,,,,,,,,,,,,,,,,,,,,,,,,,,,,,,,,,,,,,,,,,,,,,,,,,,,,,,,,,,,,,,,,,,,,,,,,,,,,,,,,,,,,,,,,,,WWWWWWWWW,,,,,,,,,,,,,,,,,,,,,,,,,,,,,,,,,,,,,,,,,,,,,,,,,,,,,,,,,,,,,,,,,,,,,,,,
,,,,,,,,,,,,,,,,,,,,,,,,,,,,,,,,,,,,,,,,,,,,,,,,,,,,,,,,,,,,,,,,,,,,,,,,,,,,,,,,,,,,,,,,,,,,,,,,,,,,,,,,,,,,,,,,,,,,,,,,,,,,,,,,,,,,,,,,,,,,,,,,,,,,,,,,,,,,,,,,,,,,,,,WWWWWWWWW,,,,,,,,,,,,,,,,,,,,,,,,,,,,,,,,,,,,,,,################################,,,
,,,,,,,,,,,,,,,,,,,,,,,,,,,,,,,,,,,,,,,,,,,,,,,,,,,,,,,,,,,,,,,,,,,,,,,,,,,,,,,,,,,,,,,,,,,,,,,,,,,,,,,,,,,,,,,,,,,,,,,,,,,,,,,,,,,,,,,,,,,,,,,,,,,,,,,,,,,,,,,,,,,,,WWWWWWWWW,,,,,,,,,,,,,,,,,,,,,,,,,,,,,,,,,,,,,,,,,################################,,,
,,,,,,,,,,,,,,,,,,,,,,,,,,,,,,,,,,,,,,,,,,,,,,,,,,,,,,,,,,,,,,,,,,,,,,,,,,,,,,,,,,,,,,,,,,,,,,,,,,,,,,,,,,,,,,,,,,,,,,,,,,,,,,,,,,,,,,,,,,,,,,,,,,,,,,,,,,,,,,,,,,,,WWWWWWWW,,,,,,,,,,,,,,,,,,,,,,,,,,,,,,,,,,,,,,,,,,,###,,,,,,,,,,,,,,,,,,,,,,,,,,###,,,
,,,,,,,,,,,,,,,,,,,,,,,,,,,,,,,,,,,,,,,,,,,,,,,,,,,,,,,,,,,,,,,,,,,,,,,,,,,,,,,,,,,,,,,,,,,,,,,,,,,,,,,,,,,,,,,,,,,,,,,,,,,,,,,,,,,,,,,,,,,,,,,,,,,,,,,,,,,,,,,,,,,,WWWWWWW,,,,,,,,,,,,,,,,,,,,,,,,,,,,,,,,,,,,,,,,,,,,###,########,,,,,,,,########,###,,,
,,,,,,,,,,,,,,,,,,,,,,,,,,,,,,,,,,,,,,,,,,,,,,,,,,,,,,,,,,,,,,,,,,,,,,,,,,,,,,,,,,,,,,,,,,,,,,,,,,,,,,,,,,,,,,,,,,,,,,,,,,,,,,,,,,,,,,,,,,,,,,,,,,,,,,,,,,,,,,,,,,,,,WWWWWWW,,,,,,,,,,,,,,,,,,,,,,,,,,,,,,,,,,,,,,,,,,,###g,,,,,,,#,,,a,,,,#,,,,,,,g###,,,
,,,,,,,,,,,,,,,,,,,,,,,,,,,,,,,,,,,,,,,,,,,,,,,,,,,,,,,,,,,,,,,,,,,,,,,,,,,,,,,,,,,,,,,,,,,,,,,,,,,,,,,,,,,,,,,,,,,,,,,,,,,,,,,,,,,,,,,,,,,,,,,,,,,,,,,,,,,,,,,,,,,,,WWWWWWW,,,,,,,,,,,,,,,,,,,,,,,,,,,,,,,,,,,,,,,,,,,###,,,,,,,,#,,,,,,,,#,,,,,,,,###,,,
,,,,,,,,,,,,,,,,,,,,,,,,,,,,,,,,,,,,,,,,,,,,,,,,,,,,,,,,,,,,,,,,,,,,,,,,,,,,,,,,,,,,,,,,,,,,,,,,,,,,,,,,,,,,,,,,,,,,,,,,,,,,,,,,,,,,,,,,,,,,,,,,,,,,,,,,,,,,,,,,,,,,WWWWWWW,,,,,,,,,,,,,,,,,,,,,,,,,,,,,,,,,,,,,,,,,,,,###,,,,,,,,##########,,,,,,,,###,,,
,,,,,,,,,,,,,,,,,,,,,,,,,,,,,,,,,,,,,,,,,,,,,,,,,,,,,,,,,,,,,,,,,,,,,,,,,,,,,,,,,,,,,,,,,,,,,,,,,,,,,,,WWWWWWWWWWWWWWWWW,,,,,,,,,,,,,,,,,,,,,,,,,,,,,,,,,,,,,,WWWWWWWWWWW,,,,,,,,,,,,,,,,,,,,,,,,,,,,,,,g,,,g,,,,,,,,,,###,,,,,,,,,,,,,,,,,,,,,,,,,,###,,,
,,,,,,,,,,,,,,,,,,,,,,,,,,,,,,,,,,,,,,,,,,,,,,,,,,,,,,,,,,,,,,,,,,,,,,,,,,,,,,,,,,,,,,,,,,,,,,,,,WWWWWWWWWWWWWWWWWWWWWWWWWWWWWWWWWWWW,,,,,,,,,,,,,,,,,,,,,,WWWWWWWWWWW,,,,,,,,,,,,,,,,g,,g,,,g,,,,,,,,,,,,g,,,,,,,,,,,,###,,,,,,,,,,,,h,,,,,,,,,,,,,###,,,
,,,,,,,,,,,,,,,,,,,,,,,,,,,,,,,,,,,,,,,,,,,,,,,,,,,,,,,,,,,,,,,,,,,,,,,,,,,,,,,,,,,,,,,,,,,,,,,WWWWWWWWWWWWWWWWWWWWWWWWWWWWWWWWWWWWWWWWWW,,,,,,,,,,,,,,,WWWWWWWWWWW,,,,,,,,,,,,,,,,,,,,,,,,,,,,,,,,,,,,,,,,,,,,,,,,,,,,###,,,,,,,,,,,,,,,,,,,,,,,,,,###,,,
,,,,,,,,,,,,,,,,,,,,,,,,,,,,,,,,,,,WWWWWWWWWWWWW,,,,,,,,,,,,WWWWWWWWWWWWWWWWW,,,,,,,,,,,,,,,,,WWWWWWWW,,,,,,,,,,,,,,,,,,,,,,,WWWWWWWWWWWWWWWW,,,,,,WWWWWWWWWWW,,,,,,,,,,,,,,,,,,,,,g,,g,,,g,,,,,,,,,,,,,,,,,,,,,,,,,,,,###,,,,,,,,,,,,,,,,,,,,,,,,,,###,,,
,,,,,,,,,,,,,,,,,,,,,,,,,,,,,,,WWWWWWWWWWWWWWWWWWWWWWWWWWWWWWWWWWWWWWWWWWWWWWWWWWWWWWWWWWWWWWWWWWWWWW,,,,,,,,,,,,,,,,,,,,,,,,,,,,,,,,WWWWWWWWWWWWWWWWWWW,,,,,,,,,,,,,,,,,,,,,,,,,,,,,,,,,,,,,,,,,,,,,,,,,,,,,,,,,,,,,,,##############,,,,##############,,,
,,,,,,,,,,,,,,,,,,,,,,,,,,,,,WWWWWWWWWWWWWWWWWWWWWWWWWWWWWWWWWWWWWWWWWWWWWWWWWWWWWWWWWWWWWWWWWWWWWW,,,,,,,,,,,,,,,,,,,,,,,,,,,,,,,,,,,,,,,,,WWWWWWWW,,,,,,,,,,,,,,,,,,,,,,,,,,,,,,,,,,,,,,,,,,,,,,,,,,,,,,,,,,,,,,,,,,,###,,,,,,,,,,,,,,,,,,,,,,,,,,###,,,
,,,,,,,,,,,,,,,,,,,,,,,,,,,,WWWWWWWWWWW,,,,,,,,,,WWWWWWWWWWWW,,,,,,,,,,,,,,,,WWWWWWWWWWWWWWWW,,,,,,,,,,,,g,,g,,,,,,,,,,,,,,,,,,,,,,,,,,,,,,,,,,,,,,,,,,,,,,,,,,,,,,,,,,,,,,,,,,,,,,,,,,,,,,,,,,,,,,,,,,,,,,,,,,,,,,,,,,###,,,,,,,,,,#,,,,#,,,,,,,,,,###,,,
,,,,,,,,,,,,,,,,,,,,,,,,,,WWWWWWWWW,,,,,,,,,,,,,,,,,,,,,,,,,,,,g,,,g,,,,,,,,,,,,,,,,,,,,,,,,,,,,,,,,,,,,,,,,,,,,,,,,,,,,,,,,,,,,,g,,,g,,,,,,,,,,,,,,,,,,,,,,,,,,,,,,,,,,,,,,,,,,,,,,,,,,,,,,,,,,,,,,,,,,,,g,,,g,,,,,,,,###,,,,,,,,g,#,,,,#,g,,,,,,,,###,,,
,,,,,,,,,,,,,,,,,,,,,,,,WWWWWWWWW,,,,,,,,,,,,g,,,,,,,,,,,,,,,,,,,,,,,,g,,,,,,,,,,,,,,,,,,,,,,,,,,,,,,,,,,,,,,,,,,,,,,,,,,,,,,,,,,,,,,,,,,,,,,,,,,,,,,,,,,,,,,,,,,,,,,,,,,,,,,,,,,,,,,,,,,,,,,,,,,,,,,,,,g,,,g,,,g,,,,,,###,,,,,,,,,,#,,,,#,,,,,,,,,,###,,,
,,,,,,,,,,,,,,,,,,,,,,WWWWWWWWW,,,,,,,,,,,,,,,,,,,,,,,,,,,,,,,,,,,,,,,,,,,,,,,,,,,,,,,,,,,,,,,,,,,,,,,,,,,,,,,,,,,,,,,,,,,,,,,,,,,,,,,,,,,,,,,,,,,,,,,,,,,,,,,,,,,,,,,,,,,,,,,,,,,,,,,,,,,,,,,,,,,,,,,,,,,,g,,,,,,,,,,,###,,,,,,,,,,#,,,,#,,,,,,,,,,###,,,
,,,,,,,,,,,,,,,,,,,,WWWWWWWWW,,,,,,,,,,,,,g,,g,,g,,,,,,,,,,,,,,,,,,,,,,,,,,,,,,,,,,,,,,,,,,,,,,,,,,,,,,,,,,,,,,,,,,,,,,,,,,,,,,,,,,,,,,,,,,,,,,,,,,,,,,,,,,,,,,,,,,,,,,,,,,,,,,,,,,,,,,,,,,,,,,,,,,,,,,,,,,,,,,g,,,,,,,###,,g,,g,,,,#,,,,#,,,,g,,g,,###,,,
,,,,,,,,,,,,,,,,,,WWWWWWWWW,,,,,,,,,,,,,,,,,,,,,,,,,,,,,,,,,,,,,,,,,,,,,,,,,,,,,,,,,,,,,,,,,,,g,,,,,,,,,,,,,,,,,,,,,,,,,,,,,,,,,,,,,,,,,,,,,,,,,,,,,,,,,,,,,,,,,,,,,,,,,,,,,,,,,,,,,,,,,,,,,,,,,,,,,,,,,,,,,,,,,,,,,,,,###,,,,g,,,,,#,,,,#,,,,,g,,,,###,,,
,,,,,,,,,,,,,,,,WWWWWWWW,,,,,,,,,,,,,,,,,,,,,g,,,,,,,,,,,,,,,,,,,,,,,,,,,,,,,,,,,,,,,,,,,,,,,,,,,,,,,,,,,,,,,,,,,,,,,,,,,,,,,,,,,,,,,,,,,,,,,,,,,,,,,,,,,,,,,,,,,,,,,,,,,,,,,,,,,,,,,,,,,,,,,,,,,,,,,,,,,,,,,,,,,,,,,,,###,,,,,,,,,,#,,,,#,,,,,,,,,,###,,,
,,,,,,,,,,,,,,,WWWWWWWW,,,,,,,,,,,,,,,,,,,,,,,,,,,,,,,,,,,,,,,,,,,,,,,,,,,,,,,,,,,,,,,,,,,,,,g,,g,,,,,,,,,,,,,,,,,,,,,,,,,,,,,,,,,,,,,,,,,,,,,,,,,,,,,,,,,,,,,,,,,,,,,,,,,,,,,,,,,,,,,,,,,,,,,,,,,,,,,,,,,,,,,,,,,,,,,,##############,,,,##############,,,
,,,,,,,,,,,,,,WWWWWWWW,,,,,,,,,,,,,,,,,,,,,,,,,,,,,,,,,,,,,,,,,,,,,,,,,,,,,,,,,,,,,,,,,,,,,,,,,,,,,,,,,,,,,,,,,,,,,,,,,,,,,,,,,,,,,,,,,,,,,,,,,,,,,,,,,,,,,,,,,,,,,,,,,,,,,,,,,,,,,,,,,,,,,,,,,,,,,,,,,,,,,,,,,,,,,,,,,###,,,,,,,,,,,,,,,,,,,,,,,,,,###,,,
,,,,,,,,,,,,,WWWWWWWW,,,,,,,,,,g,,,,,,,,,,,,,,,,,,,,,,,,,,,,,,,,,,,,,,,,,,,,,,,,,,,,,,,,,,,,,,,,,,,,,,,,,,,,,,,,,,,,,,,,,,,,,,,,,,,,,,,,,,,,,,,,,,,,,,,,,,,,,,,,,,,,,,,,,,,,,,,,,,,,,,,,,,,,,,,,,,,,,,,,,,,,,g,,,g,,,,,###,,,,,,,,,,,,,,,,,,,,,,,,,,###,,,
,,,,,,,,,,............,,,,,,,,g,,g,,,,,,,,,,,,,,,,,,,,,,,,,,,,,,,,,,,,,,,,,,,,,,,,,,,,,,,,,,,,,,,,,,,,,,,,,,,,,,,,,,,,,,,,,,,,,,,,,,,,,,,,,,,,,,,,,,,,,,,,,,,,,,,,,,,,,,,,,,,,,,,,,,,,,,,,,,,,,,,,,,,,,,,,,,,,,,,,,,,,,####,,,##################,,,####,,,
,,,,,,,,,............,,,,,,,,,,,,,,,,,,,,,,,,,,,,#########,,,,,,,,,,,,,,,,,,,,,,,,,,,,,,,,,,,,,,,,,,,,,,,,,,,,,,,,,,,,,,,,,,,,,,,,,,,,,,,,,,,,,,,,,,,,,,,,,,,,,,,,,,,,,,,,,,,,,,,,,,,#########,,,,,,,,,,,,,,,,,g,,,,,,,###,,,,,,,,,,,,,,,,,,,,,,,,,,###,,,
,,,,,,,,...........,,,,,,,,,,,,,,,,,,,,,,,,,,,,,,#MMMMMMM#############################################################################################################...#############MMMMMMM#,,,,,,,,,,,,,,,,,,,,,,,,,,###,,,g,,,g,,,,,,,,g,,,g,,,###,,,,
,,,,,,,,,WWWWWWW,,,,,,,,,,,,,,,,,,,,,,,,,,,,,,,,,#MMMMMMM#############################################################################################################...#############MMMMMMM#,,,,,,,,,,,,,,,g,,,,g,,,,,,###,,,,,,,,,,,,,,,,,,,,,,###,,,,,
,,,,,,,,,WWWWWWW,,,,,,,,,,,,,,,,,,,,,,,,,,,,,,,,,#MMMMMMM#...........................................................................................................#...#...........#MMMMMMM#,,,,,,,,,,,,,,,,,,,,,,,,,,,,###,,,,,,,g,,,,,g,,,,,,###,,,,,,
,,,,,,,,,WWWWWWW,,,,,,,,,,g,,,,,,,,,,,,,,,,,,,,,,#########......###################...............................................................................####...####........#########,,,,,,,,,,,,,,,,,,,,,,,,,,,,,###,,,,,,,,,,,,,,,,,,###,,,,,,,
,,,,,,,,,,WWWWWWW,,,,,,,,g,g,,,,,,,,,,,,,,,,,,,,,,,,###.........#........#........#...............................................................................#.........#...........###,,,,,,,,,,,,,,,,,,,,,,,,,,,,,,,,,######################,,,,,,,,
,,,,,,,,,,,WWWWWWW,,,,,,,,,,,,,,,,,,,,,,,,,,,,,,,,,,###.........#........#........#............###########################################........................#.........#...........###,,,,,,,,,,,,,,,,,,,,,,,,,g,,,g,,,,####################,,,,,,,,,
,,,,,,,,,,,,WWWWWWW,,,,,,,,,,,,,,,,,,,,,,,,,,,,,,,,,###.........#........#........#............#...................##....................#........................#.........#...........###,,,,,,,,,,,,,,,,,,,,,,,,,,,,,,,,,,,####,,g,,,,g,,####,,,,,,,,,,
,,,,,,,,,,,,WWWWWWW,,,,,,,,,,,,,,,,,,,,,,,,,,,,,,,,,###.........######...#...######............#...................##....................#........................####...####...........###,,,,,,,,,,,,,,,,,,,,,,,,,,,g,,,,,,,####,,,g,,g,,,####,,,,,,,,,,
,,,,,,,,,,,,,WWWWWWWW,,,,,,,,,,,,,,,,,,,,,,,,,,,,,,,###............................................................##...................................................................###,,,,,,,,,,,,,,,,,,,,,,,,,,,,,,,,,,,####,,,,,,,,,,####,,,,,,,,,,
,,,,,,,,,,,,,WWWWWWWW,,,,,,,,,,,,,,,,,,,,,,,,,,,,,,,###............................................................##...................................................................###,,,,,,,,,,,,,,,,,,,,,,,,,,,,,,g,,,,#######,,,,#######,,,,,,,,,,
,,,,,,,,,,,,,WWWWWWWW,,,,,,,,,,,,,,,,,,,,,,,,,,,,,,,###............................................................##...................................................................###,,,,,,,,,,,,,,,,,,,,,,,,,,,,,,,,,,,,######,,,,######,,,,,,,,,,,
,,,,,,,,,,,,WWWWWWWW,,,,,,,,,,,,,,,,,,,,,,,,,,,,,,,,###........................................#...................##....................#..............................................###,,,,,,,,,,,,,,,,,,,,,,,,,,,,g,,,,,,,,,,,##,,,,##,,,,,,,,,,,,,,,
,,,,,,,,,,,WWWWWWWW,,,,,,,,,,,,,,,,,,,,,,,,,,,,,,,,,###........................................#...................##....................#..............................................###,,,,,,,,,,,,,,,,,,,,,,,,,,,,,,,,,,,,,,,g,,,,,,,,g,,,,,,,,,,,,,,
,,,,,,,,,,WWWWWWW,,,,,,,,,,,,,,,,,,,,,,,,,,,,,,,,,,,###..................#################.....#...................##....................#........###################...................###,,,,,,,,,,,,,,,,,,,,,,,,,,,,,,,,,,,,,,,,,,,,,,,,,,,,,,,,,,,,,,,
,,,,,,,,,WWWWWWWW,,,,,,,,,,,,,,,,,,,,,,,,,,,,,,,,,,,###..................#...............#.....######...#########################...######..........................#...................###,,,,,,,,,,,,,,,,,,,,,,,,,,,,,,,,,,,,,,,,,,,,,,,,,,,,,,,,,,,,,,,
,,,,,,,,WWWWWWWW,,,,,,,,,,,,,,,,,,,,,,,,,,,,,,,,,,,,###..................#...............#.....#.........................................#........#.................#...................###,,,,,,,,,,,,,,,,,,,,,,,,,,,,,,,,,,,,,,,,,,,,,,,,,,,,,,,,,,,,,,,
,,,,,,,WWWWWWWW,,,,,,,,,,,,,,,,,,,,,,,,,,,,,,,,,,,,,###..................#...............#.....#.........................................#........#.................#...................###,,,,,,,,,,,,,,,,,,,,,,,,,,,,,,,,,,,,,,,,,,,,,,,,,,,,,,,,,,,,,,,
,,,,,,WWWWWWWW,,,,,,,,,,,,,,,,,,,,,,,,,,,,,,,,,,,,,,###..................#...............#.....#.........................................#........#.................#...................###,,,,,,,,,,,,,,,,,,,,,,,,,,,,,,,,,,,,,,,,,,,,,,,,,,,,,,,,,,,,,,,
,,,,,WWWWWWWW,,,,,,,,,,,,,,,,,,,,,,,,,,,,,,,,,,,,,,,###..................#...............#.....#.........................................#........#.................#...................###,,,,,,,,,,,,,,,,,,,,,,,,,,,,,,,,,,,,,,,,,,,,,,,,,,,,,,,,,,,,,,,
,,,,WWWWWWWW,,,,,,,,,,,,,,,,,,,,,,,,,,,,,,,,,,,,,,,,###..................#...............#.....####################...####################........#.................#...................###,,,,,,,,,,,,,,,,,,,,,,,,,,,,,,,,,,,,,,,,,,,,,,,,,,,,,,,,,,,,,,,
,,,WWWWWWWW,,,,,,,,,,,,,,,,,,,,,,,,,,,,,,,,,,,,,,,,,###..................#........................................#...#...........................#.................#...................###,,,,,,,,,,,,,,,,,,,,,,,,,,,,,,,,,,,,,,,,,,,,,,,,,,,,,,,,,,,,,,,
,,WWWWWWWW,,,,,,,,,,,,,,,,,,,,,,,,,,,,,,,,,,,,,,,,,,###..................#...............#........................#...#...........................#.................#...................###,,,,,,,,,,,,,,,,,,,,,,,,,,,,,,,,,,,,,,,,,,,,,,,,,,,,,,,,,,,,,,,
,WWWWWWWW,,,,,,,,,,,,,,,,,,,,,,,,,,,,,,,,,,,,,,,,,,,###..................#...............#........................#...#...........................#.................#...................###,,,,,,,,,,,,,,,,,,,,,,,,,,,,,,,,,,,,,,,,,,,,,,,,,,,,,,,,,,,,,,,
WWWWWWWW,,,,,,,,,,,,,,,,,,,,,,,,,,,,,,,,,,,,,,,,,,,,###..................#...............#........................#...#...........................###################...................###,,,,,,,,,,,,,,,,,,,,,,,,,,,,,,,,,,,,,,,,,,,,,,,,,,,,,,,,,,,,,,,
WWWWWWW,,,,,,,,,,,,,,,,,,,,,,,,,,,,,,,,,,,,,,,,,,,,,###..................#################...................######...######............................................................###,,,,,,,,,,,,,,,,,,,,,,,,,,,,,,,,,,,,,,,,,,,,,,,,,,,,,,,,,,,,,,,
WWWWWW,,,,,,,,,,,,,,,,,,,,,,,,,,,,,,,,,,,,,,,,,,,,,,###......................................................#.............#............................................................###,,,,,,,,,,,,,,,,,,,,,,,,,,,,,,,,,,,,,,,,,,,,,,,,,,,,,,,,,,,,,,,
WWWWW,,,,,,,,,,,,,,,,,,,,,,,,,,,,,,,,,,,,,,,,,,,,,,,###......................................................#.............#............................................................###,,,,,,,,,,,,,,,,,,,,,,,,,,,,,,,,,,,,,,,,,,,,,,,,,,,,,,,,,,,,,,,
WWWW,,,,,,,,,,,,,,,,,,,,,,,,,,,,,,,,,,,,,,,,,,,,,,,,###......................................................#.............#......................#...################..................###,,,,,,,,,,,,,,,,,,,,,,,,,,,,,,,,,,,,,,,,,,,,,,,,,,,,,,,,,,,,,,,
WWW,,,,,,,,,,,,,,,,,,,,,,,,,,,,,,,,,,,,,,,,,,,,,,,,,###..................##################..................#.............#......................#..................#..................###,,,,,,,,,,,,,,,,,,,,,,,,,,,,,,,,,,,,,,,,,,,,,,,,,,,,,,,,,,,,,,,
WW,,,,,,,,,,,,,,,,,,,,,,,,,,,,,,,,,,,,,,,,,,,,,,,,,,###..................#................#..................#.............#......................#..................#..................###,,,,,,,,,,,,,,,,,,,,,,,,,,,,,,,,,,,,,,,,,,,,,,,,,,,,,,,,,,,,,,,
W,,,,,,,,,,,,,,,,,,,,,,,,,,,,,,,,,,,,,,,,,,,,,,,,,,,###..................#................#..............##########...##########..................#..................#..................###,,,,,,,,,,,,,,,,,,,,,,,,,,,,,,,,,,,,,,,,,,,,,,,,,,,,,,,,,,,,,,,
,,,,,,,,,,,,,,,,,,,,,,,,,,,,,,,,,,,,,,,,,,,,,,,,,,,,###..................#................#..............#.....................#..................#..................#..................###,,,,,,,,,,,,,,,,,,,,,,,,,,,,,,,,,,,,,,,,,,,,,,,,,,,,,,,,,,,,,,,
,,,,,,,,,,,,,,,,,,,,,,,,,,,,,,,,,,,,,,,,,,,,,,,,,,,,###..................#................#..............#.....................#..................#..................#..................###,,,,,,,,,,,,,,,,,,,,,,,,,,,,,,,,,,,,,,,,,,,,,,,,,,,,,,,,,,,,,,,
,,,,,,,,,,,,,,,,,,,,,,,,,,,,,,,,,,,,,,,,,,,,,,,,,,,,###..................#...............................#.....................#..................#..................#..................###,,,,,,,,,,,,,,,,,,,,,,,,,,,,,,,,,,,,,,,,,,,,,,,,,,,,,,,,,,,,,,,
,,,,,,,,,,,,,,,,,,,,,,,,,,,,,,,,,,,,,,,,,,,,,,,,,,,,###..................#................#..............#.....................#..................#..................#..................###,,,,,,,,,,,,,,,,,,,,,,,,,,,,,,,,,,,,,,,,,,,,,,,,,,,,,,,,,,,,,,,
,,,,,,,,,,,,,,,,,,,,,,,,,,,,,,,,,,,,,,,,,,,,,,,,,,,,###..................#................#..............#.....................#..................#..................#..................###,,,,,,,,,,,,,,,,,,,,,,,,,,,,,,,,,,,,,,,,,,,,,,,,,,,,,,,,,,,,,,,
,,,,,,,,,,,,,,,,,,,,,,,,,,,,,,,,,,,,,,,,,,,,,,,,,,,,###..................#................#..............#.....................#..................####################..................###,,,,,,,,,,,,,,,,,,,,,,,,,,,,,,,,,,,,,,,,,,,,,,,,,,,,,,,,,,,,,,,
,,,,,,,,,,,,,,,,,,,,,,,,,,,,,,,,,,,,,,,,,,,,,,,,,,,,###..................#................#..............#..........P..........#........................................................###,,,,,,,,,,,,,,,,,,,,,,,,,,,,,,,,,,,,,,,,,,,,,,,,,,,,,,,,,,,,,,,
,,,,,,,,,,,,,,,,,,,,,,,,,,,,,,,,,,,,,,,,,,,,,,,,,,,,###..................##################..............#######################........................................................###,,,,,,,,,,,,,,,,,,,,,,,,,,,,,,,,,,,,,,,,,,,,,,,,,,,,,,,,,,,,,,,
,,,,,,,,,,,,,,,,,,,,,,,,,,,,,,,,,,,,,,,,,,,,,,,,,,,,###.................................................................................................................................###,,,,,,,,,,,,,,,,,,,,,,,,,,,,,,,,,,,,,,,,,,,,,,,,,,,,,,,,,,,,,,,
,,,,,,,,,,,,,,,,,,,,,,,,,,,,,,,,,,,,,,,,,,,,,,,,,#########...........................................................................................................................#########,,,,,,,,,,,,,,,,,,,,,,,,,,,,,,,,,,,,,,,,,,,,,,,,,,,,,,,,,,,,
,,,,,,,,,,,,,,,,,,,,,,,,,,,,,,,,,,,,,,,,,,,,,,,,,#MMMMMMM#...........................................................................................................................#MMMMMMM#,,,,,,,,,,,,,,,,,,,,,,,,,,,,,,,,,,,,,,,,,,,,,,,,,,,,,,,,,,,,
,,,,,,,,,,,,,,,,,,,,,,,,,,,,,,,,,,,,,,,,,,,,,,,,,#MMMMMMM#############################################################################################################################MMMMMMM#,,,,,,,,,,,,,,,,,,,,,,,,,,,,,,,,,,,,,,,,,,,,,,,,,,,,,,,,,,,,
,,,,,,,,,,,,,,,,,,,,,,,,,,,,,,,,,,,,,,,,,,,,,,,,,#MMMMMMM#############################################################################################################################MMMMMMM#,,,,,,,,,,,,,,,,,,,,,,,,,,,,,,,,,,,,,,,,,,,,,,,,,,,,,,,,,,,,
,,,,,,,,,,,,,,,,,,,,,,,,,,,,,,,,,,,,,,,,,,,,,,,,,#########,,,,,,,,,,,,,,,,,,,,,,,,,,,,,,,,,,,,,,,,,,,,,,,,,,,,,,,,,,,,,,,,,,,,,,,,,,,,,,,,,,,,,,,,,,,,,,,,,,,,,,,,,,,,,,,,,,,,,,,,,,,#########,,,,,,,,,,,,,,,,,,,,,,,,,,,,,,,,,,,,,,,,,,,,,,,,,,,,,,,,,,,,
,,,,,,,,,,,,,,,,,,,,,,,,,,,,,,,,,,,,,,,,,,,,,,,,,,,,,,,,,,,,,,,,,,,,,,,,,,,,,,,,,,,,,,,,,,,,,,,,,,,,,,,,,,,,,,,,,,,,,,,,,,,,,,,,,,,,,,,,,,,,,,,,,,,,,,,,,,,,,,,,,,,,,,,,,,,,,,,,,,,,,,,,,,,,,,,,,,,,,,,,,,,,,,,,,,,,,,,,,,,,,,,,,,,,,,,,,,,,,,,,,,,,,,,,,,
,,,,,,,,,,,,,,,,,,,,,,,,,,,,,,,,,,,,,,,,,,,,,,,,,,,,,,,,,,,,,,,,,,,,,,,,,,,,,,,,,,,,,,,,,,,,,,,,,,,,,,,,,,,,,,,,,,,,,,,,,,,,,,,,,,,,,,,,,,,,,,,,,,,,,,,,,,,,,,,,,,,,,,,,,,,,,,,,,,,,,,,,,,,,,,,,,,,,,,,,,,,,,,,,,,,,,,,,,,,,,,,,,,,,,,,,,,,,,,,,,,,,,,,,,,
,,,,,,,,,,,,,,,,,,,,,,,,,,,,,,,,,,,,,,,,,,,,,,,,,,,,,,,,,,,,,,,,,,,,,,,,,,,,,,,,,,,,,,,,,,,,,,,,,,,,,,,,,,,,,,,,,,,,,,,,,,,,,,,,,,,,,,,,,,,,,,,,,,,,,,,,,,,,,,,,,,,,,,,,,,,,,,,,,,,,,,,,,,,,,,,,,,,,,,,,,,,,,,,,,,,,,,,,,,,,,,,,,,,,,,,,,,,,,,,,,,,,,,,,,,
